[
  {
    "r": 170,
    "b": 170,
    "w": 100,
    "g": 255,
    "x": 200,
    "h": 10,
    "y": 490
  },
  {
    "r": 255,
    "b": 255,
    "w": 73,
    "g": 255,
    "x": 150,
    "h": 261,
    "y": 247
  }
]